111111111111111111
1C00000000000000P1
100000000000000001
100110110110110001
100010010010010001
1E0010110110010001
100010010010010001
100010110110010001
1C00000000000000C1
111111111111111111
